"filename", "language", "TOML", "Rust", "YAML", "Python", "comment", "blank", "total"
"/home/kamran/Projects/rproxy/.github/workflows/rust.yml", "YAML", 0, 0, 30, 0, 14, 7, 51
"/home/kamran/Projects/rproxy/Cargo.lock", "TOML", 1185, 0, 0, 0, 2, 154, 1341
"/home/kamran/Projects/rproxy/Cargo.toml", "TOML", 29, 0, 0, 0, 1, 5, 35
"/home/kamran/Projects/rproxy/build.rs", "Rust", 0, 131, 0, 0, 10, 13, 154
"/home/kamran/Projects/rproxy/src/base64_step.rs", "Rust", 0, 115, 0, 0, 1, 11, 127
"/home/kamran/Projects/rproxy/src/entry_module.rs", "Rust", 0, 12, 0, 0, 3, 3, 18
"/home/kamran/Projects/rproxy/src/http_entry_nonblocking.rs", "Rust", 0, 225, 0, 0, 2, 35, 262
"/home/kamran/Projects/rproxy/src/http_step.rs", "Rust", 0, 81, 0, 0, 2, 17, 100
"/home/kamran/Projects/rproxy/src/http_tools.rs", "Rust", 0, 193, 0, 0, 9, 40, 242
"/home/kamran/Projects/rproxy/src/lib.rs", "Rust", 0, 31, 0, 0, 0, 15, 46
"/home/kamran/Projects/rproxy/src/main.rs", "Rust", 0, 94, 0, 0, 4, 13, 111
"/home/kamran/Projects/rproxy/src/pipeline_module.rs", "Rust", 0, 127, 0, 0, 2, 23, 152
"/home/kamran/Projects/rproxy/src/random_salt_step.rs", "Rust", 0, 136, 0, 0, 5, 13, 154
"/home/kamran/Projects/rproxy/src/stdio_entry.rs", "Rust", 0, 84, 0, 0, 0, 11, 95
"/home/kamran/Projects/rproxy/src/stdio_step.rs", "Rust", 0, 63, 0, 0, 0, 12, 75
"/home/kamran/Projects/rproxy/src/stream_step.rs", "Rust", 0, 0, 0, 0, 63, 10, 73
"/home/kamran/Projects/rproxy/src/tcp_entry.rs", "Rust", 0, 129, 0, 0, 13, 20, 162
"/home/kamran/Projects/rproxy/src/tcp_entry_nonblocking.rs", "Rust", 0, 173, 0, 0, 2, 24, 199
"/home/kamran/Projects/rproxy/src/tcp_step.rs", "Rust", 0, 82, 0, 0, 2, 16, 100
"/home/kamran/Projects/rproxy/src/websocket_entry.rs", "Rust", 0, 198, 0, 0, 2, 18, 218
"/home/kamran/Projects/rproxy/src/websocket_entry_nonblocking.rs", "Rust", 0, 436, 0, 0, 5, 40, 481
"/home/kamran/Projects/rproxy/src/websocket_step.rs", "Rust", 0, 326, 0, 0, 19, 44, 389
"/home/kamran/Projects/rproxy/tools/echo.py", "Python", 0, 0, 0, 11, 1, 6, 18
"Total", "-", 1214, 2636, 30, 11, 162, 550, 4603